7, 7
1, 0
6, 4
X0XXXXX
X000X0X
XXX0X0X
X0X0X0X
X0X0000
X000X0X
XXXXXXX